....................................................
............XXXXXXXXX.X..........................XXX
............XXX....XXXX..........................XXX
XXXX........XXX.X....XXXXXX................XXXXXXXXX
XXX.............X..XXXXXX..............XXXXXXXXXXX..
X...............XXXX........XX......................
........XXXX.......X..X...XXX.......................
XXXXXXXXXXXXXXX....XXXX.........................XXXX
XXXXXXX.........................XXX............XXXXX
